*********************************************************************
*                ********************                               *
******* ********     ***************** ***** ******* ************** *
******* ************ *****************       ******* ************** *
*******      ******* ***************** ************* ************** *
******* **** ******* ***************** *************                *
******* **** ******* ***************** ************* ************** *
******* ****                                ******** ************** *
******* **** ************* **************** ******** ************** *
******* **** *****                                                  *
******* **** ***** ************************ *************** ***** ***
******* **** ***** ************************ *************** ***** ***
*                                                     ***** ***** ***
* ***** ********** ****************** *************** ***** ***** ***
* ***** ********** ****************** *************** ***** ***** ***
* ***** ********** ****************** ***************             ***
*                  ****************** *************** ***** ***** ***
* **************** ****************** *************** ***** ***** ***
* **************** ****************** *************** ***** ***** ***
* **************** ****************** ***************             ***
*                                     *******************************
*********************************************************************
